[Intro]
e---9----11/12--12---12p11----9p7-----9---7---4------------9----11/12--12---12p11----9p7------4----2---0--|
b---------------------------------------------------------------------------------------------------------|
g---------------------------------------------------------------------------------------------------------|
d---------------------------------------------------------------------------------------------------------|
a---------------------------------------------------------------------------------------------------------|
E---------------------------------------------------------------------------------------------------------|



************************************

| p  Pull-off
| /  Slide up

************************************